# lvlwidth 32
# lvlheight 28
# bgcolor 0 0 0
# edgecolor 0 0 255
# fillcolor 0 0 0
# pelletcolor 255 255 255
# fruittype 1
# padw 0
# padh 0

# startleveldata
0 0 0 0 0 0 0 0 0 0 0 0 0 0 0 0 0 0 0 0 0 0 0 0 0 0 0 0 0 0 0 0 
0 0 0 0 0 0 0 0 0 0 0 0 0 0 0 0 0 0 0 0 0 0 0 0 0 0 0 0 0 0 0 0 
0 0 0 0 0 0 0 0 0 0 0 0 0 0 0 0 0 0 0 0 0 0 0 0 0 0 0 0 0 0 0 0 
0 0 0 0 0 0 0 0 0 0 0 0 0 0 0 0 0 0 0 0 0 0 0 0 0 0 0 0 0 0 0 0 
0 0 0 0 0 0 107 100 100 100 100 100 100 100 100 100 100 100 100 100 100 100 100 100 108 0 0 0 0 0 0 0 
0 0 0 0 0 0 101 2 2 2 2 2 2 2 2 2 2 2 2 2 2 2 2 2 101 0 0 0 0 0 0 0 
0 0 0 0 0 0 101 3 120 2 113 2 111 100 108 2 107 100 112 2 113 2 120 3 101 0 0 0 0 0 0 0 
0 0 0 0 0 0 101 2 2 2 101 2 2 2 101 2 101 2 2 2 101 2 2 2 101 0 0 0 0 0 0 0 
0 0 0 0 0 0 101 2 111 100 106 2 113 2 110 2 110 2 113 2 105 100 112 2 101 0 0 0 0 0 0 0 
0 0 0 0 0 0 101 2 2 2 2 2 101 2 2 2 2 2 101 2 2 2 2 2 101 0 0 0 0 0 0 0 
0 0 0 0 0 0 101 2 120 2 111 100 130 100 112 2 111 100 130 100 112 2 120 2 101 0 0 0 0 0 0 0 
0 0 0 0 0 0 101 2 2 2 2 2 2 2 2 2 2 2 2 2 2 2 2 2 101 0 0 0 0 0 0 0 
0 0 0 0 0 0 105 100 108 2 113 2 111 100 100 100 100 100 112 2 113 2 107 100 106 0 0 0 0 0 0 0 
0 0 0 0 0 0 0 0 101 2 101 2 2 0 0 13 0 0 2 2 101 2 101 0 0 0 0 0 0 0 0 0 
0 0 0 0 0 0 0 0 101 2 105 112 2 107 112 1 111 108 2 111 106 2 101 0 0 0 0 0 0 0 0 0 
0 0 0 0 0 0 0 0 101 2 0 0 2 101 10 11 12 101 2 0 0 2 101 0 0 0 0 0 0 0 0 0 
0 0 0 0 0 0 107 100 106 2 111 112 2 105 100 100 100 106 2 111 112 2 105 100 108 0 0 0 0 0 0 0 
0 0 0 0 0 0 101 2 2 2 0 0 2 0 0 0 0 0 2 0 0 2 2 2 101 0 0 0 0 0 0 0 
0 0 0 0 0 0 101 2 120 2 107 112 2 111 100 100 100 112 2 111 108 2 120 2 101 0 0 0 0 0 0 0 
0 0 0 0 0 0 101 2 2 2 101 2 0 0 0 4 0 0 0 2 101 2 2 2 101 0 0 0 0 0 0 0 
0 0 0 0 0 0 105 133 112 2 110 2 111 100 100 133 100 100 112 2 110 2 111 133 106 0 0 0 0 0 0 0 
0 0 0 0 0 0 0 101 2 2 2 2 2 2 2 101 2 2 2 2 2 2 2 101 0 0 0 0 0 0 0 0 
0 0 0 0 0 0 0 101 2 111 112 2 111 108 2 101 2 107 112 2 111 112 2 101 0 0 0 0 0 0 0 0 
0 0 0 0 0 107 100 106 2 2 2 2 2 101 2 101 2 101 2 2 2 2 2 105 100 108 0 0 0 0 0 0 
0 0 0 0 0 101 2 2 2 111 100 112 2 110 2 110 2 110 2 111 100 112 2 2 2 101 0 0 0 0 0 0 
0 0 0 0 0 101 3 120 2 2 2 2 2 2 2 2 2 2 2 2 2 2 2 120 3 101 0 0 0 0 0 0 
0 0 0 0 0 101 2 2 2 107 100 100 100 100 100 100 100 100 100 100 100 108 2 2 2 101 0 0 0 0 0 0 
0 0 0 0 0 105 100 100 100 106 0 0 0 0 0 0 0 0 0 0 0 105 100 100 100 106 0 0 0 0 0 0 
# endleveldata

# sprites
