# lvlwidth 37
# lvlheight 27
# bgcolor 0 0 0
# edgelightcolor 203 211 44
# edgeshadowcolor 0 64 0
# fillcolor 0 0 0
# pelletcolor 255 0 0
# fruittype 1
# padw 16
# padh 4

# startleveldata
0 0 0 0 0 0 0 0 0 0 0 0 0 0 0 0 0 0 0 0 0 0 0 0 0 0 0 0 0 0 0 0 0 0 0 0 0 
0 0 0 0 0 0 0 0 0 0 0 0 0 0 0 0 0 0 0 0 0 0 0 0 0 0 0 0 0 0 0 0 0 0 0 0 0 
0 0 0 0 0 0 0 0 0 0 0 0 0 0 0 0 0 0 0 0 0 0 0 0 0 0 0 0 0 0 0 0 0 0 0 0 0 
0 0 0 0 0 0 0 0 0 0 0 0 0 0 0 0 0 0 0 0 0 0 0 0 0 0 0 0 0 0 0 0 0 0 0 0 0 
0 0 0 0 0 0 0 0 0 0 0 0 0 0 0 0 0 0 0 0 107 100 100 100 100 100 133 100 100 100 100 100 108 0 0 0 0 
0 0 0 0 0 0 0 0 0 0 0 0 0 0 0 0 0 0 0 0 101 2 2 2 2 2 110 2 2 2 2 2 101 0 0 0 0 
0 0 0 0 0 0 0 0 0 0 0 0 0 0 0 0 0 0 0 0 101 2 113 2 113 2 2 2 113 2 113 2 101 0 0 0 0 
0 0 0 0 0 0 0 0 0 0 0 0 0 0 0 0 107 100 100 100 106 3 110 2 110 2 113 2 110 2 110 3 105 100 100 100 108 
0 0 0 0 0 0 0 0 0 0 0 0 0 0 0 0 101 2 2 2 2 2 2 2 2 2 101 2 2 2 2 2 2 2 2 2 101 
0 0 0 0 0 0 0 0 0 0 0 0 0 0 0 0 101 2 107 100 112 2 113 0 111 100 140 100 112 0 113 2 111 100 108 2 101 
0 0 0 0 0 0 0 0 0 0 0 0 0 0 0 0 101 2 101 2 2 2 101 0 0 0 101 0 0 0 101 2 2 2 101 2 101 
0 0 0 0 0 0 0 0 0 0 0 0 0 0 0 0 101 2 110 2 111 100 130 100 112 0 110 0 111 100 130 100 112 2 110 2 101 
0 0 0 0 0 0 0 0 0 0 0 0 0 0 0 0 101 2 2 2 0 0 0 0 0 0 10 0 0 0 0 0 0 2 2 2 101 
0 0 0 0 0 0 0 0 0 0 0 0 0 0 0 0 101 2 111 100 100 100 112 0 107 112 1 111 108 0 111 100 100 100 112 2 101 
0 0 0 0 0 0 0 0 0 0 0 0 0 0 0 0 101 2 2 2 2 2 0 0 101 11 12 13 101 0 0 2 2 2 2 2 101 
0 0 0 0 0 0 0 0 0 0 0 0 0 0 0 0 105 100 100 100 100 100 108 2 131 100 100 100 132 2 107 100 100 100 100 100 106 
0 0 0 0 0 0 0 0 0 0 0 0 0 0 0 0 0 0 0 0 0 0 101 2 110 0 0 0 110 2 101 0 0 0 0 0 0 
0 0 0 0 0 0 0 0 0 0 0 0 0 0 0 0 107 100 100 100 100 100 106 2 0 0 113 0 0 2 105 100 100 100 100 100 108 
0 0 0 0 0 0 0 0 0 0 0 0 0 0 0 0 101 2 2 2 2 2 2 2 111 100 140 100 112 2 2 2 2 2 2 2 101 
0 0 0 0 0 0 0 0 0 0 0 0 0 0 0 0 101 2 113 2 107 100 108 0 0 0 101 0 0 0 107 100 108 2 113 2 101 
0 0 0 0 0 0 0 0 0 0 0 0 0 0 0 0 101 2 101 2 110 0 105 100 112 0 110 0 111 100 106 0 110 2 101 2 101 
0 0 0 0 0 0 0 0 0 0 0 0 0 0 0 0 101 2 101 2 2 2 2 2 2 2 4 2 2 2 2 2 2 2 101 2 101 
0 0 0 0 0 0 0 0 0 0 0 0 0 0 0 0 101 2 110 2 120 2 111 100 108 2 113 2 107 100 112 2 120 2 110 2 101 
0 0 0 0 0 0 0 0 0 0 0 0 0 0 0 0 101 2 2 2 3 2 2 2 101 2 101 2 101 2 2 2 3 2 2 2 101 
0 0 0 0 0 0 0 0 0 0 0 0 0 0 0 0 105 100 108 2 111 100 112 2 110 2 110 2 110 2 111 100 112 2 107 100 106 
0 0 0 0 0 0 0 0 0 0 0 0 0 0 0 0 0 0 101 2 2 2 2 2 2 2 2 2 2 2 2 2 2 2 101 0 0 
0 0 0 0 0 0 0 0 0 0 0 0 0 0 0 0 0 0 105 100 100 100 100 100 100 100 100 100 100 100 100 100 100 100 106 0 0 
# endleveldata

# sprites
