# lvlwidth 37
# lvlheight 27
# bgcolor 0 0 0
# edgelightcolor 255 255 255
# edgeshadowcolor 100 100 100
# fillcolor 175 175 175
# pelletcolor 255 0 0
# fruittype 2

# startleveldata
0 0 0 0 0 0 0 0 0 0 0 0 0 0 0 0 0 0 0 0 0 0 0 0 0 0 0 0 0 0 0 0 0 0 0 0 0 
0 0 0 0 0 0 0 0 0 0 0 0 0 0 0 0 0 0 0 0 0 0 0 0 0 0 0 0 0 0 0 0 0 0 0 0 0 
0 0 0 0 0 0 0 0 0 0 0 0 0 0 0 0 0 0 0 0 0 0 0 0 0 0 0 0 0 0 0 0 0 0 0 0 0 
0 0 0 0 0 0 0 0 0 0 0 0 0 0 0 0 0 0 0 0 0 0 0 0 0 0 0 0 0 0 0 0 0 0 0 0 0 
0 0 0 0 0 0 0 0 0 0 0 0 0 0 0 0 107 133 133 133 133 133 133 133 133 133 133 133 133 133 133 133 133 133 133 133 108 
0 0 0 0 0 0 0 0 0 0 0 0 0 0 0 0 131 140 130 130 130 130 130 130 130 130 130 130 130 130 130 130 130 130 130 140 132 
0 0 0 0 0 0 0 0 0 0 0 0 0 0 0 0 131 132 2 2 2 2 2 2 2 2 2 2 2 2 2 2 2 2 2 131 132 
0 0 0 0 0 0 0 0 0 0 0 0 0 0 0 0 131 132 2 111 100 108 2 107 133 112 2 111 133 108 2 107 100 112 2 131 132 
0 0 0 0 0 0 0 0 0 0 0 0 0 0 0 0 131 132 2 2 2 101 2 131 132 2 2 2 131 132 2 101 2 2 2 131 132 
0 0 0 0 0 0 0 0 0 0 0 0 0 0 0 0 105 106 2 120 3 110 2 105 106 2 120 2 105 106 2 110 3 120 2 105 106 
0 0 0 0 0 0 0 0 0 0 0 0 0 0 0 0 20 0 2 2 2 2 2 2 2 2 2 2 2 2 2 2 2 2 2 0 20 
0 0 0 0 0 0 0 0 0 0 0 0 0 0 0 0 107 108 2 107 108 2 111 112 0 111 100 112 0 111 112 2 107 108 2 107 108 
0 0 0 0 0 0 0 0 0 0 0 0 0 0 0 0 131 132 2 131 132 2 0 0 0 0 10 0 0 0 0 2 131 132 2 131 132 
0 0 0 0 0 0 0 0 0 0 0 0 0 0 0 0 131 132 2 105 106 2 120 0 107 112 1 111 108 0 120 2 105 106 2 131 132 
0 0 0 0 0 0 0 0 0 0 0 0 0 0 0 0 131 132 2 2 2 2 0 0 101 11 12 13 101 0 0 2 2 2 2 131 132 
0 0 0 0 0 0 0 0 0 0 0 0 0 0 0 0 105 106 2 120 2 111 112 0 105 100 100 100 106 0 111 112 2 120 2 105 106 
0 0 0 0 0 0 0 0 0 0 0 0 0 0 0 0 20 0 2 2 2 2 2 2 2 0 0 0 2 2 2 2 2 2 2 0 20 
0 0 0 0 0 0 0 0 0 0 0 0 0 0 0 0 107 108 2 113 2 120 2 113 2 120 0 120 2 113 2 120 2 113 2 107 108 
0 0 0 0 0 0 0 0 0 0 0 0 0 0 0 0 131 132 2 101 2 2 2 101 2 2 4 2 2 101 2 2 2 101 2 131 132 
0 0 0 0 0 0 0 0 0 0 0 0 0 0 0 0 131 132 2 110 2 111 100 130 100 112 0 111 100 130 100 112 2 110 2 131 132 
0 0 0 0 0 0 0 0 0 0 0 0 0 0 0 0 131 132 2 2 2 2 2 2 2 2 2 2 2 2 2 2 2 2 2 131 132 
0 0 0 0 0 0 0 0 0 0 0 0 0 0 0 0 105 106 2 120 3 120 2 120 2 113 2 113 2 120 2 120 3 120 2 105 106 
0 0 0 0 0 0 0 0 0 0 0 0 0 0 0 0 20 0 2 2 2 2 2 2 2 101 2 101 2 2 2 2 2 2 2 0 20 
0 0 0 0 0 0 0 0 0 0 0 0 0 0 0 0 107 108 2 111 100 112 2 111 100 106 2 105 100 112 2 111 100 112 2 107 108 
0 0 0 0 0 0 0 0 0 0 0 0 0 0 0 0 131 132 2 2 2 2 2 2 2 2 2 2 2 2 2 2 2 2 2 131 132 
0 0 0 0 0 0 0 0 0 0 0 0 0 0 0 0 131 140 133 133 133 133 133 133 133 133 133 133 133 133 133 133 133 133 133 140 132 
0 0 0 0 0 0 0 0 0 0 0 0 0 0 0 0 105 130 130 130 130 130 130 130 130 130 130 130 130 130 130 130 130 130 130 130 106 
# endleveldata

# sprites
