# lvlwidth 34
# lvlheight 28
# bgcolor 0 0 0
# edgecolor 85 0 170
# fillcolor 128 0 255
# pelletcolor 255 255 255
# fruittype 2
# padw 0
# padh 0

# startleveldata
0 0 0 0 0 0 0 0 0 0 0 0 0 0 0 0 0 0 0 0 0 0 0 0 0 0 0 0 0 0 0 0 0 0 
0 0 0 0 0 0 0 0 0 0 0 0 0 0 0 0 0 0 0 0 0 0 0 0 0 0 0 0 0 0 0 0 0 0 
0 0 0 0 0 0 0 0 0 0 0 0 0 0 0 0 0 0 0 0 0 0 0 0 0 0 0 0 0 0 0 0 0 0 
0 0 0 0 0 0 0 0 0 0 0 0 0 0 0 0 0 0 0 0 0 0 0 0 0 0 0 0 0 0 0 0 0 0 
0 0 0 0 0 0 0 0 0 0 0 0 0 0 0 0 0 0 0 0 0 0 0 0 0 0 0 0 0 0 0 0 0 0 
0 0 0 0 0 0 0 0 0 0 0 0 0 0 0 0 0 0 0 0 0 0 0 0 0 0 0 0 0 0 0 0 0 0 
0 0 107 100 100 100 100 100 100 100 100 133 100 100 100 100 100 100 100 100 100 100 100 133 100 100 100 100 100 100 100 100 108 0 
0 0 101 2 2 2 2 2 2 2 2 101 2 2 2 2 2 2 2 2 2 2 2 101 2 2 2 2 2 2 2 2 101 0 
0 0 101 3 111 112 2 113 2 113 2 110 2 111 100 100 100 133 100 100 100 112 2 110 2 113 2 113 2 111 112 3 101 0 
0 0 101 2 2 2 2 101 2 101 0 0 2 2 2 2 2 101 2 2 2 2 2 0 0 101 2 101 2 2 2 2 101 0 
0 0 101 2 111 100 100 106 2 105 100 112 2 111 100 108 0 101 0 107 100 112 2 111 100 106 2 105 100 100 112 2 101 0 
0 0 101 2 2 2 2 2 2 2 2 2 2 0 0 110 0 110 0 110 0 0 2 2 2 2 2 2 2 2 2 2 101 0 
0 0 131 100 100 112 2 111 100 108 2 107 100 112 0 0 0 10 0 0 0 111 100 108 2 107 100 112 2 111 100 100 132 0 
0 0 101 2 2 2 2 2 2 110 2 110 0 0 0 107 112 1 111 108 0 0 0 110 2 110 2 2 2 2 2 2 101 0 
0 0 101 2 120 0 111 112 2 2 2 2 2 113 0 101 11 12 13 101 0 113 2 2 2 2 2 111 112 0 120 2 101 0 
0 0 101 2 2 2 2 2 2 120 0 111 100 132 2 105 100 100 100 106 2 131 100 112 0 120 2 2 2 2 2 2 101 0 
0 0 101 2 111 100 100 112 2 2 2 3 2 110 2 2 2 2 2 2 2 110 2 3 2 2 2 111 100 100 112 2 101 0 
0 0 101 2 2 2 2 2 2 113 0 113 2 2 2 113 2 113 2 113 2 2 2 113 0 113 2 2 2 2 2 2 101 0 
0 0 101 2 111 112 0 120 2 110 0 110 2 111 100 106 2 110 2 105 100 112 2 110 0 110 2 120 0 111 112 2 101 0 
0 0 101 2 2 2 2 2 2 2 2 2 2 2 2 2 2 4 2 2 2 2 2 2 2 2 2 2 2 2 2 2 101 0 
0 0 105 100 108 2 107 112 0 111 100 100 100 112 0 111 100 133 100 112 0 111 100 100 100 112 0 111 108 2 107 100 106 0 
0 0 0 0 101 2 101 2 2 2 2 2 2 2 2 2 2 101 2 2 2 2 2 2 2 2 2 2 101 2 101 0 0 0 
0 0 107 100 106 2 101 2 113 2 111 133 100 100 100 108 2 110 2 107 100 100 100 133 112 2 113 2 101 2 105 100 108 0 
0 0 101 2 2 2 101 2 101 2 2 101 2 2 2 101 2 2 2 101 2 2 2 101 2 2 101 2 101 2 2 2 101 0 
0 0 101 2 120 3 110 2 105 112 2 110 2 113 2 110 2 120 2 110 2 113 2 110 2 111 106 2 110 3 120 2 101 0 
0 0 101 2 2 2 2 2 2 2 2 2 2 101 2 2 2 2 2 2 2 101 2 2 2 2 2 2 2 2 2 2 101 0 
0 0 105 100 100 100 100 100 100 100 100 100 100 130 100 100 100 100 100 100 100 130 100 100 100 100 100 100 100 100 100 100 106 0 
0 0 0 0 0 0 0 0 0 0 0 0 0 0 0 0 0 0 0 0 0 0 0 0 0 0 0 0 0 0 0 0 0 0 
# endleveldata

# sprites
