# lvlwidth 32
# lvlheight 28
# bgcolor 0 0 0
# edgelightcolor 251 233 130
# edgeshadowcolor 124 70 16
# fillcolor 225 151 51
# pelletcolor 255 255 255
# fruittype 3
# padw 0
# padh 0

# startleveldata
0 0 0 0 0 0 0 0 0 0 0 0 0 0 0 0 0 0 0 0 0 0 0 0 0 0 0 0 0 0 0 0 
0 0 0 0 0 0 0 0 0 0 0 0 0 0 0 0 0 0 0 0 0 0 0 0 0 0 0 0 0 0 0 0 
0 0 0 0 0 0 0 0 0 0 0 0 0 0 0 0 0 0 0 0 0 0 0 0 0 0 0 0 0 0 0 0 
0 0 0 0 0 0 107 100 100 100 100 100 108 0 0 0 0 0 107 100 100 100 100 100 108 0 0 0 0 0 0 0 
0 0 0 0 0 0 101 3 2 2 2 2 101 0 0 0 0 0 101 2 2 2 2 3 101 0 0 0 0 0 0 0 
0 0 0 0 0 0 101 2 107 100 108 2 101 0 0 0 0 0 101 2 107 100 108 2 101 0 0 0 0 0 0 0 
0 0 0 0 0 0 101 2 101 0 101 2 105 100 100 100 100 100 106 2 101 0 101 2 101 0 0 0 0 0 0 0 
0 0 0 0 0 0 101 2 101 0 101 2 2 2 2 2 2 2 2 2 101 0 101 2 101 0 0 0 0 0 0 0 
0 0 0 0 0 0 101 2 101 0 131 133 133 133 133 133 133 133 133 133 132 0 101 2 101 0 0 0 0 0 0 0 
0 0 0 0 0 0 101 2 131 133 140 140 130 130 130 130 130 130 130 140 140 133 132 2 101 0 0 0 0 0 0 0 
0 0 0 0 0 0 101 2 105 130 130 106 2 2 2 10 2 2 2 105 130 130 106 2 101 0 0 0 0 0 0 0 
0 0 0 0 0 0 101 0 2 2 0 0 2 107 112 1 111 108 2 0 0 2 2 0 101 0 0 0 0 0 0 0 
0 0 0 0 0 0 105 100 108 2 107 108 2 101 11 12 13 101 2 107 108 2 107 100 106 0 0 0 0 0 0 0 
0 0 0 0 0 0 0 0 101 2 105 106 2 105 100 100 100 106 2 105 106 2 101 0 0 0 0 0 0 0 0 0 
0 0 0 0 0 0 0 0 101 2 2 2 2 2 2 2 2 2 2 2 2 2 101 0 0 0 0 0 0 0 0 0 
0 0 0 0 0 0 0 0 101 2 113 2 107 100 100 100 100 100 108 2 113 2 101 0 0 0 0 0 0 0 0 0 
0 0 0 0 0 0 0 0 101 0 101 2 110 0 0 4 0 0 110 2 101 0 101 0 0 0 0 0 0 0 0 0 
0 0 0 0 0 0 107 100 106 0 101 2 2 2 111 133 112 2 2 2 101 0 105 100 108 0 0 0 0 0 0 0 
0 0 0 0 0 0 101 2 2 2 110 2 113 2 2 101 2 2 113 2 110 2 2 2 101 0 0 0 0 0 0 0 
0 0 0 0 0 0 101 2 113 0 0 2 131 108 2 101 2 107 132 2 0 0 113 2 101 0 0 0 0 0 0 0 
0 0 0 0 0 0 101 2 105 100 108 2 105 106 2 110 2 105 106 2 107 100 106 2 101 0 0 0 0 0 0 0 
0 0 0 0 0 0 101 3 2 2 101 2 2 2 2 0 2 2 2 2 101 2 2 3 101 0 0 0 0 0 0 0 
0 0 0 0 0 0 105 100 108 2 110 2 111 100 100 133 100 100 112 2 110 2 107 100 106 0 0 0 0 0 0 0 
0 0 0 0 0 0 0 0 101 0 2 2 2 2 2 110 2 2 2 2 2 0 101 0 0 0 0 0 0 0 0 0 
0 0 0 0 0 0 0 0 105 100 100 100 100 108 2 2 2 107 100 100 100 100 106 0 0 0 0 0 0 0 0 0 
0 0 0 0 0 0 0 0 0 0 0 0 0 105 100 100 100 106 0 0 0 0 0 0 0 0 0 0 0 0 0 0 
0 0 0 0 0 0 0 0 0 0 0 0 0 0 0 0 0 0 0 0 0 0 0 0 0 0 0 0 0 0 0 0 
0 0 0 0 0 0 0 0 0 0 0 0 0 0 0 0 0 0 0 0 0 0 0 0 0 0 0 0 0 0 0 0 
# endleveldata

# sprites
