# lvlwidth 32
# lvlheight 28
# bgcolor 0 0 0
# edgelightcolor 128 255 0
# edgeshadowcolor 128 255 0
# fillcolor 0 128 0
# pelletcolor 0 255 255
# fruittype 4
# padw 0
# padh 0

# startleveldata
0 0 0 0 0 0 0 0 0 0 0 0 0 0 0 0 0 0 0 0 0 0 0 0 0 0 0 0 0 0 0 0 
0 0 0 0 0 0 0 0 0 0 0 0 0 0 0 0 0 0 0 0 0 0 0 0 0 0 0 0 0 0 0 0 
0 0 0 0 0 0 0 0 0 0 0 0 0 0 0 0 0 0 0 0 0 0 0 0 0 0 0 0 0 0 0 0 
0 0 0 0 0 107 100 100 100 108 0 0 0 0 0 0 0 0 0 0 0 0 0 0 0 0 0 0 0 0 0 0 
0 0 0 0 0 101 3 2 2 105 100 100 100 100 100 100 100 100 100 100 100 100 100 100 108 0 0 0 0 0 0 0 
0 0 0 0 0 101 2 113 2 2 2 2 2 2 2 2 2 2 2 2 2 2 2 3 101 0 0 0 0 0 0 0 
0 0 0 0 0 101 2 105 133 100 108 2 111 100 108 2 107 100 112 2 107 100 108 2 101 0 0 0 0 0 0 0 
0 0 0 0 0 101 2 2 101 0 101 2 2 2 101 2 101 2 2 2 101 0 101 2 101 0 0 0 0 0 0 0 
0 0 0 0 0 105 108 2 105 100 106 2 113 2 110 2 110 2 113 2 105 100 106 2 101 0 0 0 0 0 0 0 
0 0 0 0 0 0 101 2 2 2 2 2 101 2 2 2 2 2 101 2 2 2 2 2 101 0 0 0 0 0 0 0 
0 0 0 0 0 0 101 2 113 2 111 100 130 100 112 2 111 100 130 100 112 2 113 2 101 0 0 0 0 0 0 0 
0 0 0 0 0 0 101 2 101 2 2 2 2 2 2 2 2 2 2 2 2 2 101 2 101 0 0 0 0 0 0 0 
0 0 0 0 0 0 101 2 110 2 113 2 111 100 100 100 100 100 112 2 113 2 110 2 101 0 0 0 0 0 0 0 
0 0 0 0 0 0 101 3 2 2 101 2 2 0 0 10 0 0 2 2 101 2 2 3 101 0 0 0 0 0 0 0 
0 0 0 0 0 0 131 100 112 2 105 112 2 107 112 1 111 108 2 111 106 2 111 100 132 0 0 0 0 0 0 0 
0 0 0 0 0 0 101 0 2 2 2 2 2 101 11 12 13 101 2 2 2 2 2 0 101 0 0 0 0 0 0 0 
0 0 0 0 0 0 131 100 112 2 111 112 2 105 100 100 100 106 2 111 112 2 111 100 132 0 0 0 0 0 0 0 
0 0 0 0 0 0 101 2 2 2 2 2 2 2 2 2 2 2 2 2 2 2 2 2 101 0 0 0 0 0 0 0 
0 0 0 0 0 0 101 2 113 0 107 112 2 111 100 100 100 112 2 111 108 0 113 2 101 0 0 0 0 0 0 0 
0 0 0 0 0 0 101 2 101 0 101 2 2 0 0 4 0 0 2 2 101 0 101 2 101 0 0 0 0 0 0 0 
0 0 0 0 0 0 101 2 110 0 110 2 111 100 100 133 100 100 112 2 110 0 110 2 101 0 0 0 0 0 0 0 
0 0 0 0 0 0 101 2 2 2 2 2 2 2 2 101 2 2 2 2 2 2 2 2 101 0 0 0 0 0 0 0 
0 0 0 0 0 0 101 2 120 2 120 2 111 112 2 110 2 111 112 2 120 2 120 2 101 0 0 0 0 0 0 0 
0 0 0 0 0 0 101 3 2 2 2 2 2 2 2 2 2 2 2 2 2 2 2 3 101 0 0 0 0 0 0 0 
0 0 0 0 0 0 105 100 100 100 100 100 100 100 100 100 100 100 100 100 100 100 100 100 106 0 0 0 0 0 0 0 
0 0 0 0 0 0 0 0 0 0 0 0 0 0 0 0 0 0 0 0 0 0 0 0 0 0 0 0 0 0 0 0 
0 0 0 0 0 0 0 0 0 0 0 0 0 0 0 0 0 0 0 0 0 0 0 0 0 0 0 0 0 0 0 0 
0 0 0 0 0 0 0 0 0 0 0 0 0 0 0 0 0 0 0 0 0 0 0 0 0 0 0 0 0 0 0 0 
# endleveldata

# sprites
