# lvlwidth 32
# lvlheight 28
# bgcolor 0 0 0
# edgelightcolor 0 128 192
# edgeshadowcolor 0 51 51
# fillcolor 0 0 0
# pelletcolor 255 128 0
# fruittype 2
# padw 0
# padh 0

# startleveldata
0 0 0 0 0 0 0 0 0 0 0 0 0 0 0 0 0 0 0 0 0 0 0 0 0 0 0 0 0 0 0 0 
0 0 0 0 0 0 0 0 0 0 0 0 0 0 0 0 0 0 0 0 0 0 0 0 0 0 0 0 0 0 0 0 
0 0 0 0 0 0 0 0 0 0 0 0 0 0 0 0 0 0 0 0 0 0 0 0 0 0 0 0 0 0 0 0 
0 0 0 0 0 0 0 0 0 0 0 0 0 0 0 0 0 0 0 0 0 0 0 0 0 0 0 0 0 0 0 0 
0 0 0 0 0 0 0 0 0 0 0 0 0 0 0 0 0 0 0 0 0 0 0 0 0 0 0 0 0 0 0 0 
0 0 0 0 0 0 0 0 0 0 0 0 0 0 0 0 0 0 0 0 0 0 0 0 0 0 0 0 0 0 0 0 
0 0 0 0 0 0 0 0 107 100 100 100 100 100 100 100 100 100 100 100 100 100 108 0 0 0 0 0 0 0 0 0 
0 0 0 0 0 0 0 0 101 2 2 2 2 2 2 2 2 2 2 2 2 2 101 0 0 0 0 0 0 0 0 0 
0 0 0 0 0 0 107 100 106 2 113 2 120 2 111 133 112 2 120 0 113 2 105 100 108 0 0 0 0 0 0 0 
0 0 0 0 0 0 101 2 2 2 101 2 2 2 2 101 2 2 2 0 110 2 0 0 101 0 0 0 0 0 0 0 
0 0 0 0 0 0 101 2 107 100 106 0 111 112 0 110 2 111 112 2 2 2 113 0 101 0 0 0 0 0 0 0 
0 0 0 0 0 107 106 2 110 2 2 2 0 2 2 2 2 0 0 2 120 3 110 0 105 108 0 0 0 0 0 0 
0 0 0 0 0 101 2 2 2 2 113 2 113 2 113 2 111 100 108 2 0 0 10 0 0 101 0 0 0 0 0 0 
0 0 0 0 0 101 2 107 100 100 106 2 110 2 101 2 2 2 101 2 107 112 1 111 133 106 0 0 0 0 0 0 
0 0 0 0 0 101 2 110 2 2 2 2 0 2 105 100 112 2 110 2 101 11 12 13 101 0 0 0 0 0 0 0 
0 0 0 0 0 101 2 0 3 120 2 111 108 2 2 2 2 2 2 2 105 100 100 100 130 108 0 0 0 0 0 0 
0 0 0 0 0 101 2 113 2 2 2 2 105 100 108 2 107 100 112 2 2 2 2 2 2 101 0 0 0 0 0 0 
0 0 0 0 0 101 2 105 100 100 108 2 2 2 101 2 101 2 2 2 107 100 100 112 2 101 0 0 0 0 0 0 
0 0 0 0 0 101 2 0 0 0 105 100 112 2 110 2 110 2 111 100 106 2 2 2 2 101 0 0 0 0 0 0 
0 0 0 0 0 101 2 111 108 2 2 2 2 2 2 2 2 2 2 2 2 2 107 112 2 101 0 0 0 0 0 0 
0 0 0 0 0 101 2 2 110 2 111 100 112 2 120 4 111 100 112 2 120 2 110 2 2 101 0 0 0 0 0 0 
0 0 0 0 0 105 108 2 0 2 2 2 2 2 2 2 2 2 2 2 2 2 0 2 107 106 0 0 0 0 0 0 
0 0 0 0 0 0 101 2 111 112 0 107 100 112 2 113 0 111 100 108 2 111 112 2 101 0 0 0 0 0 0 0 
0 0 0 0 0 0 101 2 2 2 3 101 2 2 2 101 0 0 0 101 2 2 2 2 101 0 0 0 0 0 0 0 
0 0 0 0 0 0 105 100 108 2 111 106 2 111 100 130 100 112 0 105 112 2 107 100 106 0 0 0 0 0 0 0 
0 0 0 0 0 0 0 0 101 2 2 2 2 2 2 2 2 2 2 2 2 2 101 0 0 0 0 0 0 0 0 0 
0 0 0 0 0 0 0 0 105 100 100 100 100 100 100 100 100 100 100 100 100 100 106 0 0 0 0 0 0 0 0 0 
0 0 0 0 0 0 0 0 0 0 0 0 0 0 0 0 0 0 0 0 0 0 0 0 0 0 0 0 0 0 0 0 
# endleveldata

# sprites
