# lvlwidth 32
# lvlheight 28
# bgcolor 0 0 0
# edgecolor 128 0 64
# fillcolor 215 0 107
# pelletcolor 0 255 0
# fruittype 3
# padw 0
# padh 0

# startleveldata
0 0 0 0 0 0 0 0 0 0 0 0 0 0 0 0 0 0 0 0 0 0 0 0 0 0 0 0 0 0 0 0 0 
0 0 0 0 0 0 0 0 0 0 0 0 0 0 0 0 0 0 0 0 0 0 0 0 0 0 0 0 0 0 0 0 0 
0 0 0 0 0 0 0 0 0 0 0 0 0 0 0 0 0 0 0 0 0 0 0 0 0 0 0 0 0 0 0 0 0 
0 0 0 0 0 0 0 0 0 0 0 0 0 0 0 0 0 0 0 0 0 0 0 0 0 0 0 0 0 0 0 0 0 
0 0 0 0 0 0 0 0 0 0 0 0 0 0 0 0 0 0 0 0 0 0 0 0 0 0 0 0 0 0 0 0 0 
0 0 0 0 0 0 0 0 0 0 0 0 0 0 0 0 0 0 0 0 0 0 0 0 0 0 0 0 0 0 0 0 0 
0 0 0 0 0 0 107 100 100 100 100 100 100 100 100 100 100 100 100 100 100 100 100 100 108 0 0 0 0 0 0 0 
0 0 0 0 0 0 101 2 2 2 2 2 2 2 2 2 2 2 2 2 2 2 2 2 101 0 0 0 0 0 0 0 
0 0 0 0 0 0 101 3 120 2 111 100 108 2 111 100 112 2 107 100 112 2 120 3 101 0 0 0 0 0 0 0 
0 0 0 0 0 0 101 2 2 2 2 2 101 2 2 2 2 2 101 2 2 2 2 2 101 0 0 0 0 0 0 0 
0 0 0 0 0 0 131 100 112 2 120 2 110 2 113 2 113 2 110 2 120 2 111 100 132 0 0 0 0 0 0 0 
0 0 0 0 0 0 101 0 0 2 2 2 2 2 101 2 101 2 2 2 2 2 0 0 101 0 0 0 0 0 0 0 
0 0 0 0 0 0 101 0 120 2 113 2 111 100 106 2 105 100 112 2 113 2 120 0 101 0 0 0 0 0 0 0 
0 0 0 0 0 0 101 2 2 2 101 2 0 0 0 10 0 0 0 2 101 2 2 2 101 0 0 0 0 0 0 0 
0 0 0 0 0 0 101 2 111 100 130 112 2 107 112 1 111 108 2 111 130 100 112 2 101 0 0 0 0 0 0 0 
0 0 0 0 0 0 101 2 2 2 2 2 2 101 11 12 13 101 2 2 2 2 2 2 101 0 0 0 0 0 0 0 
0 0 0 0 0 0 101 2 111 133 100 112 2 105 100 100 100 106 2 111 100 133 112 2 101 0 0 0 0 0 0 0 
0 0 0 0 0 0 101 2 2 101 2 2 2 0 0 0 0 0 2 2 2 101 2 2 101 0 0 0 0 0 0 0 
0 0 0 0 0 0 131 112 2 110 2 107 100 112 0 113 0 111 100 108 2 110 2 111 132 0 0 0 0 0 0 0 
0 0 0 0 0 0 101 2 2 2 2 101 2 2 2 101 2 2 2 101 2 2 2 2 101 0 0 0 0 0 0 0 
0 0 0 0 0 0 101 2 120 0 111 106 2 120 2 101 2 120 2 105 112 0 120 2 101 0 0 0 0 0 0 0 
0 0 0 0 0 0 101 2 2 2 2 2 2 2 2 101 2 2 2 2 2 2 2 2 101 0 0 0 0 0 0 0 
0 0 0 0 0 0 131 100 112 2 111 108 2 111 100 130 100 112 2 107 112 2 111 100 132 0 0 0 0 0 0 0 
0 0 0 0 0 0 101 2 2 2 2 101 2 2 2 4 2 2 2 101 2 2 2 2 101 0 0 0 0 0 0 0 
0 0 0 0 0 0 101 3 111 112 2 105 100 112 2 120 2 111 100 106 2 111 112 3 101 0 0 0 0 0 0 0 
0 0 0 0 0 0 101 2 2 2 2 2 2 2 2 2 2 2 2 2 2 2 2 2 101 0 0 0 0 0 0 0 
0 0 0 0 0 0 105 100 100 100 100 100 100 100 100 100 100 100 100 100 100 100 100 100 106 0 0 0 0 0 0 0 
0 0 0 0 0 0 0 0 0 0 0 0 0 0 0 0 0 0 0 0 0 0 0 0 0 0 0 0 0 0 0 0 0 
# endleveldata

# sprites
