# lvlwidth 34
# lvlheight 28
# bgcolor 0 0 0
# edgecolor 0 0 255
# fillcolor 0 0 0
# pelletcolor 255 255 255
# fruittype 1
# padw 0
# padh 0

# startleveldata
0 0 0 0 0 0 0 0 0 0 0 0 0 0 0 0 0 0 0 0 0 0 0 0 0 0 0 0 0 0 0 0 0 0
0 0 0 0 0 0 0 0 0 0 0 0 0 0 0 0 0 0 0 0 0 0 0 0 0 0 0 0 0 0 0 0 0 0
0 0 0 0 0 0 0 0 0 0 0 0 0 0 0 0 0 0 0 0 0 0 0 0 0 0 0 0 0 0 0 0 0 0
0 0 0 0 0 0 0 0 0 0 0 0 0 0 0 0 0 0 0 0 0 0 0 0 0 0 0 0 0 0 0 0 0 0
0 0 0 0 0 0 0 0 107 100 100 100 100 100 100 100 100 100 100 100 100 100 100 100 100 100 108 0 0 0 0 0 0 0
0 0 0 0 0 0 0 0 101 0 0 0 0 0 0 0 0 0 0 0 0 0 0 0 0 0 101 0 0 0 0 0 0 0
0 0 0 0 0 0 0 0 101 3 120 0 113 0 111 100 108 0 107 100 112 0 113 0 120 3 101 0 0 0 0 0 0 0
0 0 0 0 0 0 0 0 101 0 0 0 101 0 0 0 101 0 101 0 0 0 101 0 0 0 101 0 0 0 0 0 0 0
0 0 0 0 0 0 0 0 101 0 111 100 106 0 113 0 110 0 110 0 113 0 105 100 112 0 101 0 0 0 0 0 0 0
0 0 0 0 0 0 0 0 101 0 0 0 0 0 101 0 0 0 0 0 101 0 0 0 0 0 101 0 0 0 0 0 0 0
0 0 0 0 0 0 0 0 101 0 120 0 111 100 130 100 112 0 111 100 130 100 112 0 120 0 101 0 0 0 0 0 0 0
0 0 0 0 0 0 0 0 101 0 0 0 0 0 0 0 0 0 0 0 0 0 0 0 0 0 101 0 0 0 0 0 0 0
0 0 0 0 0 0 0 0 105 100 108 0 113 0 111 100 100 100 100 100 112 0 113 0 107 100 106 0 0 0 0 0 0 0
0 0 0 0 0 0 0 0 0 0 101 0 101 0 0 0 0 13 0 0 0 0 101 0 101 0 0 0 0 0 0 0 0 0
0 0 0 0 0 0 0 0 0 0 101 0 105 112 0 107 112 1 111 108 0 111 106 0 101 0 0 0 0 0 0 0 0 0
0 0 0 0 0 0 0 0 0 0 101 0 0 0 2 101 10 11 12 101 0 0 0 0 101 0 0 0 0 0 0 0 0 0
0 0 0 0 0 0 0 0 107 100 106 0 111 112 0 105 100 100 100 106 0 111 112 0 105 100 108 0 0 0 0 0 0 0
0 0 0 0 0 0 0 0 101 0 0 0 0 0 0 0 0 0 0 0 0 0 0 0 0 0 101 0 0 0 0 0 0 0
0 0 0 0 0 0 0 0 101 0 120 0 107 112 0 111 100 100 100 112 0 111 108 0 120 0 101 0 0 0 0 0 0 0
0 0 0 0 0 0 0 0 101 0 0 0 101 0 0 0 0 4 0 0 0 0 101 0 0 0 101 0 0 0 0 0 0 0
0 0 0 0 0 0 0 0 105 133 112 0 110 0 111 100 100 133 100 100 112 0 110 0 111 133 106 0 0 0 0 0 0 0
0 0 0 0 0 0 0 0 0 101 0 0 0 0 0 0 0 101 0 0 0 0 0 0 0 101 0 0 0 0 0 0 0 0
0 0 0 0 0 0 0 0 0 101 0 111 112 0 111 108 0 101 0 107 112 0 111 112 0 101 0 0 0 0 0 0 0 0
0 0 0 0 0 0 0 107 100 106 0 0 0 0 0 101 0 101 0 101 0 0 0 0 0 105 100 108 0 0 0 0 0 0
0 0 0 0 0 0 0 101 0 0 0 111 100 112 0 110 0 110 0 110 0 111 100 112 0 0 0 101 0 0 0 0 0 0
0 0 0 0 0 0 0 101 3 120 0 0 0 0 0 0 0 0 0 0 0 0 0 0 0 120 3 101 0 0 0 0 0 0
0 0 0 0 0 0 0 101 0 0 0 107 100 100 100 100 100 100 100 100 100 100 100 108 0 0 0 101 0 0 0 0 0 0
0 0 0 0 0 0 0 105 100 100 100 106 0 0 0 0 0 0 0 0 0 0 0 105 100 100 100 106 0 0 0 0 0 0
# endleveldata

# sprites
